1 1 1 1 1 1
1 3 3 3 3 2
1 5 5 5 5 1
1 a a a a 1
1 1 1 1 1 1
